AEEEEEEEEEEEEEM
ESSSSSSSSSSSSSE
ESSSSSSSSSSSSSE
ESSSASSSSSASSSE
ESSSSSSSSSSSSSE
EEEEEEESSSSSSSE
EEEEESSSSSSSSSE
EEEEEESSSSSSSSE
EEEEESSSSSSSSSE
EEEESSSSSSSSSSE
EEESSSMMMMMSSSE
ESSSSSSSSSSSSSE
EEEEEEEEEEEEEEE