EEEEEEEEEEEEEEE
ESSSSSSSSSSSSSE
ESSSSSSSSSSSSSE
ESSSSSSSSSSSSSE
ESSSSSSSSSSSSSE
EEEEEEESSSSSSSE
EEEEESSSSSSSSSE
EEEEEESSSSSSSSE
EEEEESSSSSSSSSE
EEEESSSSSSSSSSE
EEESSSSSSSSSSSE
ESSSSSSSSSSSSSE
EEEEEEEEEEEEEEE